{
  "data": {
    "city_name": "TigerCity",
    "width": 20,
    "height": 15,
    "tiles": [
      ["C", "C", "C", "C", "C", "C", "C", "C", "C", "C", "C", "C", "C", "C", "C", "C", "C", "C", "C", "C"],
      ["C", "C", "C", "C", "C", "C", "C", "C", "C", "C", "C", "C", "C", "C", "C", "C", "C", "C", "C", "C"],
      ["C", "C", "B", "B", "B", "C", "C", "C", "C", "C", "C", "C", "C", "C", "B", "B", "B", "C", "C", "C"],
      ["C", "C", "B", "B", "B", "C", "C", "C", "C", "C", "C", "C", "C", "C", "B", "B", "B", "C", "C", "C"],
      ["C", "C", "B", "B", "B", "C", "C", "P", "P", "P", "P", "P", "P", "C", "B", "B", "B", "C", "C", "C"],
      ["C", "C", "C", "C", "C", "C", "C", "P", "P", "P", "P", "P", "P", "C", "C", "C", "C", "C", "C", "C"],
      ["C", "C", "C", "C", "C", "C", "C", "P", "P", "P", "P", "P", "P", "C", "C", "C", "C", "C", "C", "C"],
      ["C", "C", "C", "C", "C", "C", "C", "P", "P", "P", "P", "P", "P", "C", "C", "C", "C", "C", "C", "C"],
      ["C", "C", "B", "B", "B", "C", "C", "P", "P", "P", "P", "P", "P", "C", "B", "B", "B", "C", "C", "C"],
      ["C", "C", "B", "B", "B", "C", "C", "C", "C", "C", "C", "C", "C", "C", "B", "B", "B", "C", "C", "C"],
      ["C", "C", "B", "B", "B", "C", "C", "C", "C", "C", "C", "C", "C", "C", "B", "B", "B", "C", "C", "C"],
      ["C", "C", "C", "C", "C", "C", "C", "C", "C", "C", "C", "C", "C", "C", "C", "C", "C", "C", "C", "C"],
      ["C", "C", "C", "C", "C", "C", "C", "C", "C", "C", "C", "C", "C", "C", "C", "C", "C", "C", "C", "C"],
      ["C", "C", "C", "C", "C", "C", "C", "C", "C", "C", "C", "C", "C", "C", "C", "C", "C", "C", "C", "C"],
      ["C", "C", "C", "C", "C", "C", "C", "C", "C", "C", "C", "C", "C", "C", "C", "C", "C", "C", "C", "C"]
    ],
    "legend": {
      "C": {"name": "calle", "surface_weight": 1.0},
      "B": {"name": "edificio", "blocked": true},
      "P": {"name": "parque", "surface_weight": 0.95}
    },
    "goal": 3000
  }
}